# Rime table
# encoding: utf-8
# code: tabSize=32 insertSpaces=false
#@/db_name  custom_phrase.txt
#@/db_type	tabledb
#
# 码表各字段以制表符（Tab）分隔
# 顺序为：文字、编码、权重（决定重码的次序、可选）
#
# 虽然文本码表编辑较为方便，但不适合导入大量条目

中州韵输入法引擎	rime	2
https://rime.im/	rime	1
Rime	rime	3
⌘	cmd
⌘	command
⌃	ctl
⌃	control
⌥	opt
⌥	option
⇧	shift

Android	android
Apple	apple
Apple ID	appleid
Apple Music	am	2
AiMesh	am	1
AirPods	ap	4
Apple Pay	ap	3
Alipay	ap	2
Apple TV	atv
Apple Watch	aw
App Store	as	2
Apple Store	as	1
AC86U	ac	2
AppleCare+	ac	1
Clash	clash
Cloudflare	cloudflare
Cloudflare Workers	cloudflareworkers
CSS	css
Dropbox	dropbox
Docker	docker
GBK	gbk
GitHub	github
Google	google
Google Pay	gp
Google Play	gp	2
Google Voice	gv
Gmail	gm
Gboard	gb
Linux	linux
HTML	html
iCloud	icloud
iMac	imac
iOS	ios
iPad	ipad
iPhone	iphone
iPhone Xʀ	iphonexr
iPod	ipod
IPTV	iptv
IPv4	ipv
IPv6	ipv
iTunes	itunes
Java	java
JavaScript	javascript
jQuery	jquery
Linux	linux
Mac	mac
Mac App Store	mas
MacBook	macbook
MacBook Air	mba
MacBook Pro	mbp
macOS	macos	8
macOS Sequoia	macos	7
macOS Sonoma	macos	6
macOS Ventura	macos	5
macOS Monterey	macos	4
macOS Catalina	macos	3
macOS Mojave	macos	2
macOS High Sierra	macos	1
Magisk	magisk
Markdown	md
Microsoft	mic	2
Microsoft Office	mic	1
Minecraft	minecraft
MySQL	mysql
Netflix	nf
Objective-C	objc
OneDrive	onedrive
OS X	osx
Pixel	pixel
Python	python
Quantumult	quantumult
Ruby	ruby
Rust	rust
SQL	sql
Stash	stash
Surge	surge
Swift	swift
Tailscale	tailscale
Telegram	tg
TypeScript	typescript
T恤	txu
UTF-8	utf	3
UTF-16	utf	2
UTF-32	utf	1
U盘	upj
WeChat	wechat
Wi-Fi	wifi
Windows	win
Windows	windows
X-Ray	xray
Xbox	xbox
Xbox One	xboxone
YouTube	youtube
YouTube Premium	yp
ZeroTier	zerotier
Numbers	nb	1
1Password	one	2
OneDrive	one	1
openwrt	ow
Option	ot
Outlook	ol	2
outlook.com	ol	1
Photoshop	ps
Pro	pro
Safari	sf	2
Shift	sf	1
SSD	ssd	2
Spotify	sp	1
Spark	sp	2
Sublime Text	sbt
TeamViewer	tv
Telegram	tg	100
Thunderbolt	thunder
Thunderbolt Bridge	thunderbolt
Thunderbolt Ethernet	thunderbolt
Type-C	tc
Typora	ty
USB-C	usb	1
USB-A	usb	2
VirtualBox	vbox
Visual Studio Code	vscode
VSCode	vscode
WireGuard	wg
YouTube Music	ytbm
YouTube Premium	ytbp
	apple
 MUSIC	imusic
 PAY	ipay
 tv 4K	atv
 WATCH	iwatch
